ˆˆˆˆ_curyncurses 6.1.20181013
_curx=6
_maxy=33
_maxx=134
_flags=14
flag=_clear
flag=_idcok
flag=_use_keypad
_delay=-1
_regbottom=33
_bkgrnd=\s
rows:
1:\{NORMAL|C1}window\{NORMAL|C0}\s\s\s\s\s\s\s\s\s\s\s\s\s\s\s\s\s\s\s\s\s\s\s\s\s\s\s\s\s\s\s\s\s\s\s\s\s\s\s\s\s\s\s\s\s\s\s\s\s\s\s\s\s\s\s\s\s\s\s\s\s\s\s\s\s\s\s\s\s\s\s\s\s\s\s\s\s\s\s\s\s\s\s\s\s\s\s\s\s\s\s\s\s\s\s\s\s\s\s\s\s\s\s\s\s\s\s\s\s\s\s\s\s\s\s\s\s\s\s\s\s\s\s\s\s\s\s\s\s
2:\s\s\s\s\s\s\s\s\s\s\s\s\s\s\s\s\s\s\s\s\s\s\s\s\s\s\s\s\s\s\s\s\s\s\s\s\s\s\s\s\s\s\s\s\s\s\s\s\s\s\s\s\s\s\s\s\s\s\s\s\s\s\s\s\s\s\s\s\s\s\s\s\s\s\s\s\s\s\s\s\s\s\s\s\s\s\s\s\s\s\s\s\s\s\s\s\s\s\s\s\s\s\s\s\s\s\s\s\s\s\s\s\s\s\s\s\s\s\s\s\s\s\s\s\s\s\s\s\s\s\s\s\s\s\s
3:\s\s\s\s\s\s\s\s\s\s\s\s\s\s\s\s\s\s\s\s\s\s\s\s\s\s\s\s\s\s\s\s\s\s\s\s\s\s\s\s\s\s\s\s\s\s\s\s\s\s\s\s\s\s\s\s\s\s\s\s\s\s\s\s\s\s\s\s\s\s\s\s\s\s\s\s\s\s\s\s\s\s\s\s\s\s\s\s\s\s\s\s\s\s\s\s\s\s\s\s\s\s\s\s\s\s\s\s\s\s\s\s\s\s\s\s\s\s\s\s\s\s\s\s\s\s\s\s\s\s\s\s\s\s\s
4:\s\s\s\s\s\s\s\s\s\s\s\s\s\s\s\s\s\s\s\s\s\s\s\s\s\s\s\s\s\s\s\s\s\s\s\s\s\s\s\s\s\s\s\s\s\s\s\s\s\s\s\s\s\s\s\s\s\s\s\s\s\s\s\s\s\s\s\s\s\s\s\s\s\s\s\s\s\s\s\s\s\s\s\s\s\s\s\s\s\s\s\s\s\s\s\s\s\s\s\s\s\s\s\s\s\s\s\s\s\s\s\s\s\s\s\s\s\s\s\s\s\s\s\s\s\s\s\s\s\s\s\s\s\s\s
5:\s\s\s\s\s\s\s\s\s\s\s\s\s\s\s\s\s\s\s\s\s\s\s\s\s\s\s\s\s\s\s\s\s\s\s\s\s\s\s\s\s\s\s\s\s\s\s\s\s\s\s\s\s\s\s\s\s\s\s\s\s\s\s\s\s\s\s\s\s\s\s\s\s\s\s\s\s\s\s\s\s\s\s\s\s\s\s\s\s\s\s\s\s\s\s\s\s\s\s\s\s\s\s\s\s\s\s\s\s\s\s\s\s\s\s\s\s\s\s\s\s\s\s\s\s\s\s\s\s\s\s\s\s\s\s
6:\s\s\s\s\s\s\s\s\s\s\s\s\s\s\s\s\s\s\s\s\s\s\s\s\s\s\s\s\s\s\s\s\s\s\s\s\s\s\s\s\s\s\s\s\s\s\s\s\s\s\s\s\s\s\s\s\s\s\s\s\s\s\s\s\s\s\s\s\s\s\s\s\s\s\s\s\s\s\s\s\s\s\s\s\s\s\s\s\s\s\s\s\s\s\s\s\s\s\s\s\s\s\s\s\s\s\s\s\s\s\s\s\s\s\s\s\s\s\s\s\s\s\s\s\s\s\s\s\s\s\s\s\s\s\s
7:\s\s\s\s\s\s\s\s\s\s\s\s\s\s\s\s\s\s\s\s\s\s\s\s\s\s\s\s\s\s\s\s\s\s\s\s\s\s\s\s\s\s\s\s\s\s\s\s\s\s\s\s\s\s\s\s\s\s\s\s\s\s\s\s\s\s\s\s\s\s\s\s\s\s\s\s\s\s\s\s\s\s\s\s\s\s\s\s\s\s\s\s\s\s\s\s\s\s\s\s\s\s\s\s\s\s\s\s\s\s\s\s\s\s\s\s\s\s\s\s\s\s\s\s\s\s\s\s\s\s\s\s\s\s\s
8:\s\s\s\s\s\s\s\s\s\s\s\s\s\s\s\s\s\s\s\s\s\s\s\s\s\s\s\s\s\s\s\s\s\s\s\s\s\s\s\s\s\s\s\s\s\s\s\s\s\s\s\s\s\s\s\s\s\s\s\s\s\s\s\s\s\s\s\s\s\s\s\s\s\s\s\s\s\s\s\s\s\s\s\s\s\s\s\s\s\s\s\s\s\s\s\s\s\s\s\s\s\s\s\s\s\s\s\s\s\s\s\s\s\s\s\s\s\s\s\s\s\s\s\s\s\s\s\s\s\s\s\s\s\s\s
9:\s\s\s\s\s\s\s\s\s\s\s\s\s\s\s\s\s\s\s\s\s\s\s\s\s\s\s\s\s\s\s\s\s\s\s\s\s\s\s\s\s\s\s\s\s\s\s\s\s\s\s\s\s\s\s\s\s\s\s\s\s\s\s\s\s\s\s\s\s\s\s\s\s\s\s\s\s\s\s\s\s\s\s\s\s\s\s\s\s\s\s\s\s\s\s\s\s\s\s\s\s\s\s\s\s\s\s\s\s\s\s\s\s\s\s\s\s\s\s\s\s\s\s\s\s\s\s\s\s\s\s\s\s\s\s
10:\s\s\s\s\s\s\s\s\s\s\s\s\s\s\s\s\s\s\s\s\s\s\s\s\s\s\s\s\s\s\s\s\s\s\s\s\s\s\s\s\s\s\s\s\s\s\s\s\s\s\s\s\s\s\s\s\s\s\s\s\s\s\s\s\s\s\s\s\s\s\s\s\s\s\s\s\s\s\s\s\s\s\s\s\s\s\s\s\s\s\s\s\s\s\s\s\s\s\s\s\s\s\s\s\s\s\s\s\s\s\s\s\s\s\s\s\s\s\s\s\s\s\s\s\s\s\s\s\s\s\s\s\s\s\s
11:\s\s\s\s\s\s\s\s\s\s\s\s\s\s\s\s\s\s\s\s\s\s\s\s\s\s\s\s\s\s\s\s\s\s\s\s\s\s\s\s\s\s\s\s\s\s\s\s\s\s\s\s\s\s\s\s\s\s\s\s\s\s\s\s\s\s\s\s\s\s\s\s\s\s\s\s\s\s\s\s\s\s\s\s\s\s\s\s\s\s\s\s\s\s\s\s\s\s\s\s\s\s\s\s\s\s\s\s\s\s\s\s\s\s\s\s\s\s\s\s\s\s\s\s\s\s\s\s\s\s\s\s\s\s\s
12:\s\s\s\s\s\s\s\s\s\s\s\s\s\s\s\s\s\s\s\s\s\s\s\s\s\s\s\s\s\s\s\s\s\s\s\s\s\s\s\s\s\s\s\s\s\s\s\s\s\s\s\s\s\s\s\s\s\s\s\s\s\s\s\s\s\s\s\s\s\s\s\s\s\s\s\s\s\s\s\s\s\s\s\s\s\s\s\s\s\s\s\s\s\s\s\s\s\s\s\s\s\s\s\s\s\s\s\s\s\s\s\s\s\s\s\s\s\s\s\s\s\s\s\s\s\s\s\s\s\s\s\s\s\s\s
13:\s\s\s\s\s\s\s\s\s\s\s\s\s\s\s\s\s\s\s\s\s\s\s\s\s\s\s\s\s\s\s\s\s\s\s\s\s\s\s\s\s\s\s\s\s\s\s\s\s\s\s\s\s\s\s\s\s\s\s\s\s\s\s\s\s\s\s\s\s\s\s\s\s\s\s\s\s\s\s\s\s\s\s\s\s\s\s\s\s\s\s\s\s\s\s\s\s\s\s\s\s\s\s\s\s\s\s\s\s\s\s\s\s\s\s\s\s\s\s\s\s\s\s\s\s\s\s\s\s\s\s\s\s\s\s
14:\s\s\s\s\s\s\s\s\s\s\s\s\s\s\s\s\s\s\s\s\s\s\s\s\s\s\s\s\s\s\s\s\s\s\s\s\s\s\s\s\s\s\s\s\s\s\s\s\s\s\s\s\s\s\s\s\s\s\s\s\s\s\s\s\s\s\s\s\s\s\s\s\s\s\s\s\s\s\s\s\s\s\s\s\s\s\s\s\s\s\s\s\s\s\s\s\s\s\s\s\s\s\s\s\s\s\s\s\s\s\s\s\s\s\s\s\s\s\s\s\s\s\s\s\s\s\s\s\s\s\s\s\s\s\s
15:\s\s\s\s\s\s\s\s\s\s\s\s\s\s\s\s\s\s\s\s\s\s\s\s\s\s\s\s\s\s\s\s\s\s\s\s\s\s\s\s\s\s\s\s\s\s\s\s\s\s\s\s\s\s\s\s\s\s\s\s\s\s\s\s\s\s\s\s\s\s\s\s\s\s\s\s\s\s\s\s\s\s\s\s\s\s\s\s\s\s\s\s\s\s\s\s\s\s\s\s\s\s\s\s\s\s\s\s\s\s\s\s\s\s\s\s\s\s\s\s\s\s\s\s\s\s\s\s\s\s\s\s\s\s\s
16:\s\s\s\s\s\s\s\s\s\s\s\s\s\s\s\s\s\s\s\s\s\s\s\s\s\s\s\s\s\s\s\s\s\s\s\s\s\s\s\s\s\s\s\s\s\s\s\s\s\s\s\s\s\s\s\s\s\s\s\s\s\s\s\s\s\s\s\s\s\s\s\s\s\s\s\s\s\s\s\s\s\s\s\s\s\s\s\s\s\s\s\s\s\s\s\s\s\s\s\s\s\s\s\s\s\s\s\s\s\s\s\s\s\s\s\s\s\s\s\s\s\s\s\s\s\s\s\s\s\s\s\s\s\s\s
17:\s\s\s\s\s\s\s\s\s\s\s\s\s\s\s\s\s\s\s\s\s\s\s\s\s\s\s\s\s\s\s\s\s\s\s\s\s\s\s\s\s\s\s\s\s\s\s\s\s\s\s\s\s\s\s\s\s\s\s\s\s\s\s\s\s\s\s\s\s\s\s\s\s\s\s\s\s\s\s\s\s\s\s\s\s\s\s\s\s\s\s\s\s\s\s\s\s\s\s\s\s\s\s\s\s\s\s\s\s\s\s\s\s\s\s\s\s\s\s\s\s\s\s\s\s\s\s\s\s\s\s\s\s\s\s
18:\s\s\s\s\s\s\s\s\s\s\s\s\s\s\s\s\s\s\s\s\s\s\s\s\s\s\s\s\s\s\s\s\s\s\s\s\s\s\s\s\s\s\s\s\s\s\s\s\s\s\s\s\s\s\s\s\s\s\s\s\s\s\s\s\s\s\s\s\s\s\s\s\s\s\s\s\s\s\s\s\s\s\s\s\s\s\s\s\s\s\s\s\s\s\s\s\s\s\s\s\s\s\s\s\s\s\s\s\s\s\s\s\s\s\s\s\s\s\s\s\s\s\s\s\s\s\s\s\s\s\s\s\s\s\s
19:\s\s\s\s\s\s\s\s\s\s\s\s\s\s\s\s\s\s\s\s\s\s\s\s\s\s\s\s\s\s\s\s\s\s\s\s\s\s\s\s\s\s\s\s\s\s\s\s\s\s\s\s\s\s\s\s\s\s\s\s\s\s\s\s\s\s\s\s\s\s\s\s\s\s\s\s\s\s\s\s\s\s\s\s\s\s\s\s\s\s\s\s\s\s\s\s\s\s\s\s\s\s\s\s\s\s\s\s\s\s\s\s\s\s\s\s\s\s\s\s\s\s\s\s\s\s\s\s\s\s\s\s\s\s\s
20:\s\s\s\s\s\s\s\s\s\s\s\s\s\s\s\s\s\s\s\s\s\s\s\s\s\s\s\s\s\s\s\s\s\s\s\s\s\s\s\s\s\s\s\s\s\s\s\s\s\s\s\s\s\s\s\s\s\s\s\s\s\s\s\s\s\s\s\s\s\s\s\s\s\s\s\s\s\s\s\s\s\s\s\s\s\s\s\s\s\s\s\s\s\s\s\s\s\s\s\s\s\s\s\s\s\s\s\s\s\s\s\s\s\s\s\s\s\s\s\s\s\s\s\s\s\s\s\s\s\s\s\s\s\s\s
21:\s\s\s\s\s\s\s\s\s\s\s\s\s\s\s\s\s\s\s\s\s\s\s\s\s\s\s\s\s\s\s\s\s\s\s\s\s\s\s\s\s\s\s\s\s\s\s\s\s\s\s\s\s\s\s\s\s\s\s\s\s\s\s\s\s\s\s\s\s\s\s\s\s\s\s\s\s\s\s\s\s\s\s\s\s\s\s\s\s\s\s\s\s\s\s\s\s\s\s\s\s\s\s\s\s\s\s\s\s\s\s\s\s\s\s\s\s\s\s\s\s\s\s\s\s\s\s\s\s\s\s\s\s\s\s
22:\s\s\s\s\s\s\s\s\s\s\s\s\s\s\s\s\s\s\s\s\s\s\s\s\s\s\s\s\s\s\s\s\s\s\s\s\s\s\s\s\s\s\s\s\s\s\s\s\s\s\s\s\s\s\s\s\s\s\s\s\s\s\s\s\s\s\s\s\s\s\s\s\s\s\s\s\s\s\s\s\s\s\s\s\s\s\s\s\s\s\s\s\s\s\s\s\s\s\s\s\s\s\s\s\s\s\s\s\s\s\s\s\s\s\s\s\s\s\s\s\s\s\s\s\s\s\s\s\s\s\s\s\s\s\s
23:\s\s\s\s\s\s\s\s\s\s\s\s\s\s\s\s\s\s\s\s\s\s\s\s\s\s\s\s\s\s\s\s\s\s\s\s\s\s\s\s\s\s\s\s\s\s\s\s\s\s\s\s\s\s\s\s\s\s\s\s\s\s\s\s\s\s\s\s\s\s\s\s\s\s\s\s\s\s\s\s\s\s\s\s\s\s\s\s\s\s\s\s\s\s\s\s\s\s\s\s\s\s\s\s\s\s\s\s\s\s\s\s\s\s\s\s\s\s\s\s\s\s\s\s\s\s\s\s\s\s\s\s\s\s\s
24:\s\s\s\s\s\s\s\s\s\s\s\s\s\s\s\s\s\s\s\s\s\s\s\s\s\s\s\s\s\s\s\s\s\s\s\s\s\s\s\s\s\s\s\s\s\s\s\s\s\s\s\s\s\s\s\s\s\s\s\s\s\s\s\s\s\s\s\s\s\s\s\s\s\s\s\s\s\s\s\s\s\s\s\s\s\s\s\s\s\s\s\s\s\s\s\s\s\s\s\s\s\s\s\s\s\s\s\s\s\s\s\s\s\s\s\s\s\s\s\s\s\s\s\s\s\s\s\s\s\s\s\s\s\s\s
25:\s\s\s\s\s\s\s\s\s\s\s\s\s\s\s\s\s\s\s\s\s\s\s\s\s\s\s\s\s\s\s\s\s\s\s\s\s\s\s\s\s\s\s\s\s\s\s\s\s\s\s\s\s\s\s\s\s\s\s\s\s\s\s\s\s\s\s\s\s\s\s\s\s\s\s\s\s\s\s\s\s\s\s\s\s\s\s\s\s\s\s\s\s\s\s\s\s\s\s\s\s\s\s\s\s\s\s\s\s\s\s\s\s\s\s\s\s\s\s\s\s\s\s\s\s\s\s\s\s\s\s\s\s\s\s
26:\s\s\s\s\s\s\s\s\s\s\s\s\s\s\s\s\s\s\s\s\s\s\s\s\s\s\s\s\s\s\s\s\s\s\s\s\s\s\s\s\s\s\s\s\s\s\s\s\s\s\s\s\s\s\s\s\s\s\s\s\s\s\s\s\s\s\s\s\s\s\s\s\s\s\s\s\s\s\s\s\s\s\s\s\s\s\s\s\s\s\s\s\s\s\s\s\s\s\s\s\s\s\s\s\s\s\s\s\s\s\s\s\s\s\s\s\s\s\s\s\s\s\s\s\s\s\s\s\s\s\s\s\s\s\s
27:\s\s\s\s\s\s\s\s\s\s\s\s\s\s\s\s\s\s\s\s\s\s\s\s\s\s\s\s\s\s\s\s\s\s\s\s\s\s\s\s\s\s\s\s\s\s\s\s\s\s\s\s\s\s\s\s\s\s\s\s\s\s\s\s\s\s\s\s\s\s\s\s\s\s\s\s\s\s\s\s\s\s\s\s\s\s\s\s\s\s\s\s\s\s\s\s\s\s\s\s\s\s\s\s\s\s\s\s\s\s\s\s\s\s\s\s\s\s\s\s\s\s\s\s\s\s\s\s\s\s\s\s\s\s\s
28:\s\s\s\s\s\s\s\s\s\s\s\s\s\s\s\s\s\s\s\s\s\s\s\s\s\s\s\s\s\s\s\s\s\s\s\s\s\s\s\s\s\s\s\s\s\s\s\s\s\s\s\s\s\s\s\s\s\s\s\s\s\s\s\s\s\s\s\s\s\s\s\s\s\s\s\s\s\s\s\s\s\s\s\s\s\s\s\s\s\s\s\s\s\s\s\s\s\s\s\s\s\s\s\s\s\s\s\s\s\s\s\s\s\s\s\s\s\s\s\s\s\s\s\s\s\s\s\s\s\s\s\s\s\s\s
29:\s\s\s\s\s\s\s\s\s\s\s\s\s\s\s\s\s\s\s\s\s\s\s\s\s\s\s\s\s\s\s\s\s\s\s\s\s\s\s\s\s\s\s\s\s\s\s\s\s\s\s\s\s\s\s\s\s\s\s\s\s\s\s\s\s\s\s\s\s\s\s\s\s\s\s\s\s\s\s\s\s\s\s\s\s\s\s\s\s\s\s\s\s\s\s\s\s\s\s\s\s\s\s\s\s\s\s\s\s\s\s\s\s\s\s\s\s\s\s\s\s\s\s\s\s\s\s\s\s\s\s\s\s\s\s
30:\s\s\s\s\s\s\s\s\s\s\s\s\s\s\s\s\s\s\s\s\s\s\s\s\s\s\s\s\s\s\s\s\s\s\s\s\s\s\s\s\s\s\s\s\s\s\s\s\s\s\s\s\s\s\s\s\s\s\s\s\s\s\s\s\s\s\s\s\s\s\s\s\s\s\s\s\s\s\s\s\s\s\s\s\s\s\s\s\s\s\s\s\s\s\s\s\s\s\s\s\s\s\s\s\s\s\s\s\s\s\s\s\s\s\s\s\s\s\s\s\s\s\s\s\s\s\s\s\s\s\s\s\s\s\s
31:\s\s\s\s\s\s\s\s\s\s\s\s\s\s\s\s\s\s\s\s\s\s\s\s\s\s\s\s\s\s\s\s\s\s\s\s\s\s\s\s\s\s\s\s\s\s\s\s\s\s\s\s\s\s\s\s\s\s\s\s\s\s\s\s\s\s\s\s\s\s\s\s\s\s\s\s\s\s\s\s\s\s\s\s\s\s\s\s\s\s\s\s\s\s\s\s\s\s\s\s\s\s\s\s\s\s\s\s\s\s\s\s\s\s\s\s\s\s\s\s\s\s\s\s\s\s\s\s\s\s\s\s\s\s\s
32:\s\s\s\s\s\s\s\s\s\s\s\s\s\s\s\s\s\s\s\s\s\s\s\s\s\s\s\s\s\s\s\s\s\s\s\s\s\s\s\s\s\s\s\s\s\s\s\s\s\s\s\s\s\s\s\s\s\s\s\s\s\s\s\s\s\s\s\s\s\s\s\s\s\s\s\s\s\s\s\s\s\s\s\s\s\s\s\s\s\s\s\s\s\s\s\s\s\s\s\s\s\s\s\s\s\s\s\s\s\s\s\s\s\s\s\s\s\s\s\s\s\s\s\s\s\s\s\s\s\s\s\s\s\s\s
33:\s\s\s\s\s\s\s\s\s\s\s\s\s\s\s\s\s\s\s\s\s\s\s\s\s\s\s\s\s\s\s\s\s\s\s\s\s\s\s\s\s\s\s\s\s\s\s\s\s\s\s\s\s\s\s\s\s\s\s\s\s\s\s\s\s\s\s\s\s\s\s\s\s\s\s\s\s\s\s\s\s\s\s\s\s\s\s\s\s\s\s\s\s\s\s\s\s\s\s\s\s\s\s\s\s\s\s\s\s\s\s\s\s\s\s\s\s\s\s\s\s\s\s\s\s\s\s\s\s\s\s\s\s\s\s
34:\s\s\s\s\s\s\s\s\s\s\s\s\s\s\s\s\s\s\s\s\s\s\s\s\s\s\s\s\s\s\s\s\s\s\s\s\s\s\s\s\s\s\s\s\s\s\s\s\s\s\s\s\s\s\s\s\s\s\s\s\s\s\s\s\s\s\s\s\s\s\s\s\s\s\s\s\s\s\s\s\s\s\s\s\s\s\s\s\s\s\s\s\s\s\s\s\s\s\s\s\s\s\s\s\s\s\s\s\s\s\s\s\s\s\s\s\s\s\s\s\s\s\s\s\s\s\s\s\s\s\s\s\s\s\s
